,Student_ID,Gender,Nationality,PlaceofBirth,Math_exam,Essay_exam,Total,Admission
0,70484,M,KU,Egypt,22,27,49,0
1,56793,M,UK,USA,11,24,35,0
2,58228,F,EGY,UK,5,43,48,0
3,79180,F,UK,UK,37,17,54,0
4,77961,F,EGY,USA,31,68,99,0
5,61385,M,UK,Egypt,33,57,90,0
6,73294,M,LEB,Kuwait,31,15,46,0
7,77512,M,US,Kuwait,89,8,97,0
8,75415,M,UK,Kuwait,11,55,66,0
9,76021,F,KU,Kuwait,30,34,64,0
10,59002,M,US,USA,8,84,92,0
11,64276,M,UK,USA,33,13,46,0
12,54580,F,EGY,UK,0,34,34,0
13,76251,F,KU,Lebanon,16,60,76,0
14,71230,M,EGY,Lebanon,48,77,125,1
15,53985,M,UK,USA,65,22,87,0
16,79661,M,EGY,UK,77,23,100,0
17,60552,M,US,Lebanon,98,12,110,0
18,70775,M,EGY,Egypt,1,34,35,0
19,78679,M,US,Lebanon,50,69,119,0
20,52106,F,US,Kuwait,93,41,134,1
21,55744,M,US,USA,35,59,94,0
22,72585,M,KU,USA,49,63,112,0
23,77700,F,LEB,Kuwait,64,26,90,0
24,70991,M,LEB,Egypt,75,50,125,1
25,64426,M,EGY,Lebanon,38,33,71,0
26,67455,F,EGY,UK,78,43,121,0
27,54837,F,UK,UK,29,53,82,0
28,74841,F,LEB,Kuwait,22,50,72,0
29,68197,F,KU,UK,97,88,185,1
30,71416,M,EGY,Egypt,97,26,123,0
31,73935,M,KU,Kuwait,34,17,51,0
32,59220,M,KU,Egypt,86,2,88,0
33,76794,M,UK,UK,14,43,57,0
34,52944,F,US,UK,17,17,34,0
35,76100,F,EGY,UK,76,37,113,0
36,59565,F,EGY,USA,85,15,100,0
37,79598,F,EGY,Egypt,56,97,153,1
38,50449,F,KU,USA,78,47,125,1
39,69101,M,EGY,Kuwait,93,5,98,0
40,61186,M,LEB,Kuwait,18,71,89,0
41,60339,F,UK,UK,9,73,82,0
42,79621,M,UK,UK,95,63,158,1
43,50384,F,LEB,USA,39,55,94,0
44,58870,M,US,UK,71,3,74,0
45,77095,M,UK,USA,17,39,56,0
46,50258,M,UK,UK,34,37,71,0
47,50322,M,US,USA,51,93,144,1
48,78944,F,UK,UK,33,0,33,0
49,52249,M,US,UK,18,48,66,0
50,76059,M,EGY,Kuwait,37,5,42,0
51,68973,F,KU,Kuwait,81,100,181,1
52,61598,F,EGY,Lebanon,65,51,116,0
53,64970,F,UK,UK,14,42,56,0
54,62036,M,KU,Lebanon,56,24,80,0
55,52616,M,US,UK,44,2,46,0
56,66857,M,LEB,Kuwait,68,58,126,1
57,50157,F,KU,USA,52,78,130,1
58,79797,M,LEB,USA,6,9,15,0
59,54270,F,US,USA,55,43,98,0
60,62104,F,KU,Kuwait,45,98,143,1
61,50551,F,KU,Lebanon,11,57,68,0
62,62627,F,UK,UK,6,29,35,0
63,68781,M,EGY,UK,83,93,176,1
64,69541,M,KU,Lebanon,12,78,90,0
65,58668,F,UK,Egypt,8,2,10,0
66,75122,F,EGY,Lebanon,39,49,88,0
67,77233,M,UK,Lebanon,28,2,30,0
68,74759,F,LEB,Kuwait,5,25,30,0
69,79760,M,KU,Kuwait,26,98,124,0
70,50241,F,UK,USA,35,58,93,0
71,63536,F,KU,Kuwait,20,85,105,0
72,53946,F,EGY,Egypt,55,54,109,0
73,79670,F,US,UK,4,94,98,0
74,68203,F,EGY,UK,12,21,33,0
75,58960,F,UK,Egypt,87,32,119,0
76,68922,M,LEB,UK,37,39,76,0
77,55972,M,KU,Kuwait,74,60,134,1
78,56133,M,UK,Egypt,57,21,78,0
79,69414,M,EGY,Lebanon,4,88,92,0
80,74318,F,UK,Lebanon,72,32,104,0
81,58128,M,KU,USA,47,5,52,0
82,62969,F,US,USA,31,14,45,0
83,79551,M,KU,UK,78,36,114,0
84,73429,F,LEB,UK,26,22,48,0
85,78928,M,US,Kuwait,96,52,148,1
86,70227,F,LEB,Kuwait,87,24,111,0
87,65254,M,LEB,Egypt,86,32,118,0
88,50341,M,EGY,Kuwait,87,93,180,1
89,55713,M,UK,USA,49,26,75,0
90,76722,F,KU,UK,32,24,56,0
91,63710,M,UK,Egypt,53,93,146,1
92,66889,F,US,Kuwait,97,61,158,1
93,54221,F,UK,Lebanon,12,73,85,0
94,51332,F,US,USA,83,98,181,1
95,61754,F,UK,Egypt,30,82,112,0
96,69565,M,EGY,Kuwait,5,75,80,0
97,51378,F,EGY,Egypt,46,56,102,0
98,72868,M,EGY,Lebanon,31,92,123,0
99,73116,F,EGY,USA,59,50,109,0
100,55212,M,KU,Lebanon,82,70,152,1
101,64708,F,US,Egypt,42,31,73,0
102,71118,F,US,Lebanon,35,49,84,0
103,71785,F,KU,UK,79,8,87,0
104,61840,M,UK,Egypt,9,55,64,0
105,53045,M,EGY,USA,30,5,35,0
106,57236,M,EGY,Kuwait,44,70,114,0
107,71978,M,KU,USA,91,70,161,1
108,56469,M,US,Lebanon,72,97,169,1
109,61439,F,LEB,UK,52,12,64,0
110,77337,F,US,UK,45,54,99,0
111,63676,M,UK,Lebanon,17,31,48,0
112,71776,M,LEB,USA,68,27,95,0
113,58236,F,LEB,USA,83,7,90,0
114,56619,M,US,UK,52,99,151,1
115,73121,M,LEB,UK,74,18,92,0
116,50817,M,EGY,Egypt,24,91,115,0
117,57182,M,LEB,Egypt,13,83,96,0
118,63374,F,US,Lebanon,85,87,172,1
119,58301,M,UK,Kuwait,63,3,66,0
120,53923,M,EGY,Lebanon,59,59,118,0
121,54657,F,US,Egypt,61,43,104,0
122,76200,M,LEB,Egypt,2,13,15,0
123,78445,F,LEB,Kuwait,49,68,117,0
124,53601,M,KU,Kuwait,62,48,110,0
125,77671,M,KU,Kuwait,67,35,102,0
126,75853,F,UK,Egypt,42,35,77,0
127,56233,M,EGY,Kuwait,91,75,166,1
128,58821,F,EGY,USA,46,62,108,0
129,66624,M,EGY,Lebanon,22,46,68,0
130,64741,M,EGY,UK,46,80,126,1
131,69719,F,EGY,Lebanon,40,64,104,0
132,75275,F,UK,USA,58,78,136,1
133,77144,F,US,UK,63,31,94,0
134,55644,M,LEB,Egypt,46,94,140,1
135,53345,F,LEB,USA,40,39,79,0
136,51249,M,LEB,Lebanon,95,31,126,1
137,58832,M,EGY,USA,33,14,47,0
138,58530,M,LEB,Lebanon,71,80,151,1
139,72145,M,EGY,Egypt,65,92,157,1
140,71188,M,US,Kuwait,66,56,122,0
141,61892,F,EGY,Kuwait,79,68,147,1
142,63902,M,LEB,Lebanon,98,92,190,1
143,63803,F,LEB,USA,85,43,128,1
144,70020,M,EGY,UK,98,54,152,1
145,63869,M,US,USA,49,77,126,1
146,75995,F,KU,Kuwait,94,8,102,0
147,61424,F,KU,Lebanon,86,24,110,0
148,67311,M,US,Egypt,98,53,151,1
149,74251,M,US,Egypt,69,81,150,1
150,55383,F,LEB,Egypt,55,62,117,0
151,74699,M,US,Egypt,18,92,110,0
152,57556,M,KU,UK,16,34,50,0
153,67655,M,KU,Kuwait,48,40,88,0
154,61578,F,EGY,Kuwait,59,88,147,1
155,54074,F,KU,Kuwait,84,37,121,0
156,70187,M,US,Kuwait,8,27,35,0
157,67698,F,KU,Egypt,48,16,64,0
158,51644,M,US,USA,28,62,90,0
159,60024,F,KU,Egypt,42,42,84,0
160,51135,F,EGY,UK,46,92,138,1
161,62159,F,EGY,Kuwait,46,30,76,0
162,56543,F,KU,Kuwait,25,81,106,0
163,53526,F,UK,Egypt,37,99,136,1
164,64562,F,US,Lebanon,59,35,94,0
165,75692,F,UK,Kuwait,79,34,113,0
166,60762,F,EGY,USA,78,6,84,0
167,62895,M,KU,USA,12,90,102,0
168,79167,M,UK,Kuwait,22,90,112,0
169,77513,M,UK,USA,6,35,41,0
170,63214,M,EGY,Egypt,2,71,73,0
171,78798,M,LEB,USA,89,11,100,0
172,64897,M,KU,USA,83,75,158,1
173,61485,M,KU,Kuwait,63,99,162,1
174,68510,M,LEB,Egypt,76,100,176,1
175,62234,F,EGY,Kuwait,17,30,47,0
176,61529,M,US,Kuwait,40,29,69,0
177,59747,M,EGY,Kuwait,42,8,50,0
178,55958,F,LEB,USA,31,86,117,0
179,54424,F,LEB,UK,90,31,121,0
180,62246,F,LEB,Egypt,65,90,155,1
181,60818,M,UK,UK,15,2,17,0
182,72814,F,LEB,UK,12,85,97,0
183,77835,F,UK,Lebanon,20,20,40,0
184,55409,M,KU,Kuwait,61,69,130,1
185,55892,F,UK,Egypt,81,60,141,1
186,69693,F,EGY,USA,96,52,148,1
187,78887,M,UK,USA,94,8,102,0
188,56638,F,KU,Lebanon,37,31,68,0
189,69468,M,KU,USA,69,95,164,1
190,77938,M,LEB,USA,54,16,70,0
191,69105,F,US,Egypt,3,97,100,0
192,69838,F,EGY,Egypt,46,12,58,0
193,70522,F,US,Egypt,61,75,136,1
194,56561,M,UK,UK,68,78,146,1
195,63290,M,KU,USA,49,53,102,0
196,57418,M,KU,USA,60,49,109,0
197,74976,F,EGY,UK,12,35,47,0
198,72079,M,KU,Kuwait,42,13,55,0
199,50893,F,LEB,Lebanon,33,93,126,1
200,67414,M,UK,Lebanon,80,29,109,0
201,70575,M,LEB,Egypt,53,30,83,0
202,66060,M,US,USA,3,10,13,0
203,64738,M,US,UK,34,4,38,0
204,66024,F,US,Egypt,19,75,94,0
205,77168,F,LEB,Egypt,67,43,110,0
206,60903,F,LEB,Lebanon,3,25,28,0
207,66444,F,KU,Kuwait,27,96,123,0
208,69804,M,LEB,Kuwait,13,48,61,0
209,65701,F,US,Lebanon,60,56,116,0
210,75407,M,US,Egypt,40,28,68,0
211,77936,M,EGY,Kuwait,82,29,111,0
212,59747,F,LEB,UK,66,36,102,0
213,74289,F,LEB,Kuwait,67,97,164,1
214,70300,M,UK,UK,60,53,113,0
215,72437,F,US,Kuwait,36,94,130,1
216,68142,F,LEB,UK,3,68,71,0
217,61625,F,UK,Kuwait,94,49,143,1
218,69225,M,LEB,USA,41,19,60,0
219,65778,M,KU,Kuwait,81,32,113,0
220,58353,F,EGY,UK,59,47,106,0
221,58756,F,EGY,Lebanon,100,92,192,1
222,64035,F,KU,USA,30,95,125,1
223,71259,F,KU,Lebanon,66,84,150,1
224,76627,F,US,Kuwait,67,90,157,1
225,72644,F,LEB,USA,56,33,89,0
226,79816,F,US,USA,29,31,60,0
227,58251,F,US,USA,49,10,59,0
228,58952,F,US,Lebanon,86,40,126,1
229,56171,F,LEB,UK,77,15,92,0
230,73422,M,US,USA,49,81,130,1
231,63726,F,UK,Lebanon,50,78,128,1
232,58509,M,US,Kuwait,46,40,86,0
233,62194,M,EGY,USA,72,58,130,1
234,79644,F,KU,Egypt,93,15,108,0
235,79745,F,UK,USA,39,35,74,0
236,63699,M,US,Kuwait,9,19,28,0
237,68196,M,EGY,Egypt,63,73,136,1
238,74380,M,UK,USA,19,38,57,0
239,71172,F,LEB,USA,94,90,184,1
240,59184,F,UK,Lebanon,79,56,135,1
241,68809,F,US,Egypt,92,75,167,1
242,65948,F,EGY,UK,46,94,140,1
243,74703,F,KU,Egypt,71,98,169,1
244,61781,M,UK,Kuwait,6,67,73,0
245,75263,M,KU,Kuwait,44,10,54,0
246,60492,M,LEB,UK,9,31,40,0
247,64402,F,US,USA,68,51,119,0
248,66877,F,KU,Kuwait,44,98,142,1
249,51380,M,EGY,Egypt,84,95,179,1
250,71983,M,UK,USA,82,6,88,0
251,59124,F,US,UK,48,40,88,0
252,76762,F,EGY,Egypt,100,83,183,1
253,67697,M,EGY,Lebanon,18,19,37,0
254,75109,F,EGY,Egypt,23,84,107,0
255,61088,F,LEB,Egypt,32,28,60,0
256,55901,F,LEB,Kuwait,73,22,95,0
257,67860,F,US,Kuwait,54,94,148,1
258,51990,M,EGY,UK,32,53,85,0
259,72833,M,UK,Egypt,42,3,45,0
260,59428,F,LEB,Kuwait,26,54,80,0
261,50417,F,UK,Kuwait,39,36,75,0
262,54122,F,LEB,USA,39,66,105,0
263,68235,F,UK,Kuwait,29,63,92,0
264,53877,M,UK,Kuwait,86,97,183,1
265,76864,M,KU,Lebanon,79,19,98,0
266,67769,F,UK,UK,26,74,100,0
267,68304,F,EGY,UK,84,23,107,0
268,54217,M,EGY,Kuwait,85,5,90,0
269,63773,M,US,Egypt,5,85,90,0
270,76007,M,EGY,UK,83,25,108,0
271,70280,F,US,UK,44,78,122,0
272,65010,F,UK,Kuwait,9,28,37,0
273,58225,F,US,UK,1,84,85,0
274,75625,F,LEB,Lebanon,46,95,141,1
275,55063,M,UK,Lebanon,92,50,142,1
276,57908,M,KU,UK,1,69,70,0
277,72680,F,UK,Lebanon,79,23,102,0
278,62962,M,UK,Lebanon,56,87,143,1
279,52339,F,EGY,Lebanon,17,65,82,0
280,70473,F,UK,USA,34,41,75,0
281,62741,F,KU,USA,18,87,105,0
282,59879,F,KU,Egypt,25,75,100,0
283,64020,M,LEB,UK,81,30,111,0
284,68910,F,EGY,Egypt,19,56,75,0
285,69856,F,UK,Lebanon,73,61,134,1
286,69287,F,US,Kuwait,98,64,162,1
287,61634,M,US,Lebanon,56,33,89,0
288,61596,M,LEB,Kuwait,27,2,29,0
289,52316,F,EGY,Egypt,90,25,115,0
290,50505,M,KU,Kuwait,80,95,175,1
291,71680,F,UK,Egypt,12,41,53,0
292,67920,M,LEB,Lebanon,47,99,146,1
293,50319,F,LEB,Egypt,3,84,87,0
294,64231,M,EGY,Kuwait,98,79,177,1
295,72467,F,KU,Egypt,15,95,110,0
296,53789,M,LEB,Egypt,96,64,160,1
297,69215,F,KU,Lebanon,54,53,107,0
298,75115,M,LEB,Lebanon,25,13,38,0
299,55839,M,US,UK,52,90,142,1
300,79793,F,KU,Kuwait,30,33,63,0
301,53760,F,LEB,Lebanon,50,95,145,1
302,54872,M,UK,Kuwait,37,83,120,0
303,67187,M,US,Lebanon,89,68,157,1
304,53319,F,KU,UK,87,70,157,1
305,75917,M,KU,USA,7,69,76,0
306,71910,F,LEB,UK,28,41,69,0
307,62804,M,US,Lebanon,61,58,119,0
308,71788,M,UK,Lebanon,41,60,101,0
309,60614,F,KU,UK,97,51,148,1
310,70586,M,KU,USA,10,73,83,0
311,59297,M,EGY,USA,27,92,119,0
312,53994,F,LEB,Lebanon,46,17,63,0
313,79766,M,LEB,Egypt,92,82,174,1
314,72929,M,LEB,Lebanon,50,1,51,0
315,60017,F,EGY,Egypt,14,68,82,0
316,65342,M,US,Lebanon,4,8,12,0
317,63837,M,EGY,Lebanon,95,25,120,0
318,73019,F,LEB,Egypt,30,4,34,0
319,73326,F,LEB,Lebanon,27,45,72,0
320,51231,F,EGY,Egypt,30,61,91,0
321,79784,F,UK,Egypt,86,87,173,1
322,78785,F,EGY,UK,76,78,154,1
323,56918,M,EGY,UK,0,11,11,0
324,58674,F,UK,Lebanon,63,32,95,0
325,53907,F,EGY,Lebanon,68,45,113,0
326,74120,M,EGY,USA,97,42,139,1
327,51346,F,EGY,USA,96,21,117,0
328,58456,F,UK,Kuwait,58,74,132,1
329,71303,M,KU,USA,15,0,15,0
330,74132,F,LEB,Lebanon,36,3,39,0
331,64966,M,US,Egypt,31,41,72,0
332,76079,M,LEB,Lebanon,10,47,57,0
333,55239,F,EGY,Egypt,98,35,133,1
334,54377,M,US,USA,78,15,93,0
335,55920,F,KU,USA,92,9,101,0
336,77609,M,KU,USA,55,78,133,1
337,70900,M,EGY,Egypt,52,58,110,0
338,62408,M,UK,Lebanon,80,69,149,1
339,52823,F,US,Egypt,58,76,134,1
340,57896,F,KU,UK,2,15,17,0
341,54717,F,UK,Egypt,84,82,166,1
342,79825,M,LEB,USA,34,79,113,0
343,56202,M,US,Egypt,73,55,128,1
344,52458,M,EGY,Egypt,0,78,78,0
345,53064,M,UK,Kuwait,0,84,84,0
346,52364,M,EGY,UK,76,52,128,1
347,54140,F,US,Egypt,60,31,91,0
348,68429,F,EGY,UK,37,56,93,0
349,70138,M,KU,UK,86,90,176,1
350,67959,F,LEB,USA,13,65,78,0
351,79667,M,UK,Kuwait,25,81,106,0
352,70997,M,US,Kuwait,91,79,170,1
353,76750,M,US,Egypt,9,9,18,0
354,61432,M,EGY,Egypt,29,63,92,0
355,54644,M,EGY,Egypt,59,51,110,0
356,55692,M,LEB,USA,43,68,111,0
357,70386,M,US,UK,70,74,144,1
358,72167,M,US,USA,91,19,110,0
359,56580,M,EGY,UK,21,61,82,0
360,58002,F,EGY,USA,58,26,84,0
361,71980,M,UK,Lebanon,64,19,83,0
362,61966,F,UK,Kuwait,76,7,83,0
363,56988,F,LEB,Kuwait,15,28,43,0
364,72220,F,KU,USA,5,35,40,0
365,71341,F,KU,Kuwait,50,76,126,1
366,67671,F,LEB,Lebanon,29,42,71,0
367,63195,M,UK,Egypt,53,91,144,1
368,78382,M,LEB,Kuwait,20,22,42,0
369,62828,F,EGY,UK,90,53,143,1
370,61345,M,UK,Lebanon,75,64,139,1
371,72461,M,US,Egypt,89,49,138,1
372,61661,M,KU,USA,61,38,99,0
373,60031,M,EGY,UK,58,96,154,1
374,52823,M,UK,USA,9,35,44,0
375,53689,M,UK,Egypt,27,74,101,0
376,73926,F,UK,USA,93,34,127,1
377,52058,M,UK,Kuwait,25,30,55,0
378,78421,M,US,Lebanon,16,41,57,0
379,56300,M,KU,Kuwait,25,90,115,0
380,63358,M,KU,Egypt,16,47,63,0
381,50142,F,EGY,Lebanon,47,80,127,1
382,69153,F,LEB,Kuwait,9,86,95,0
383,58150,F,UK,Egypt,57,57,114,0
384,59840,M,US,Egypt,80,45,125,1
385,61058,M,UK,USA,19,98,117,0
386,79193,F,LEB,UK,70,11,81,0
387,50305,M,LEB,Lebanon,7,23,30,0
388,75170,F,UK,UK,46,71,117,0
389,73016,F,US,Lebanon,75,31,106,0
390,71301,F,US,Lebanon,91,26,117,0
391,63733,F,EGY,USA,13,80,93,0
392,68496,F,EGY,USA,80,75,155,1
393,73225,F,LEB,Lebanon,39,84,123,0
394,71297,F,US,Egypt,38,58,96,0
395,70582,M,LEB,Egypt,26,79,105,0
396,57431,M,US,Egypt,92,35,127,1
397,56669,F,KU,Kuwait,42,97,139,1
398,75644,M,UK,USA,53,58,111,0
399,55779,F,LEB,Lebanon,30,21,51,0
400,70993,F,UK,USA,90,1,91,0
401,77950,F,UK,USA,2,20,22,0
402,54725,M,KU,Kuwait,67,62,129,1
403,72709,M,UK,Lebanon,11,58,69,0
404,78629,F,LEB,Egypt,72,50,122,0
405,67590,F,UK,USA,10,5,15,0
406,78354,F,UK,Kuwait,10,8,18,0
407,59275,F,UK,UK,36,0,36,0
408,72003,F,US,Lebanon,6,90,96,0
409,60128,M,US,USA,71,81,152,1
410,69676,F,KU,Lebanon,45,82,127,1
411,67057,M,EGY,USA,26,64,90,0
412,50618,M,EGY,Kuwait,5,85,90,0
413,58723,F,UK,USA,2,97,99,0
414,69203,M,US,Egypt,56,43,99,0
415,72843,M,UK,USA,17,19,36,0
416,58749,F,EGY,UK,4,32,36,0
417,64819,F,LEB,USA,98,54,152,1
418,78050,F,UK,Egypt,41,75,116,0
419,68949,M,US,Lebanon,68,32,100,0
420,72566,M,US,Kuwait,31,0,31,0
421,67448,M,LEB,Lebanon,85,73,158,1
422,74734,F,EGY,USA,87,93,180,1
423,60507,F,KU,USA,18,85,103,0
424,67505,M,KU,Egypt,18,66,84,0
425,58347,M,LEB,Kuwait,87,19,106,0
426,54705,F,KU,USA,98,16,114,0
427,74406,F,EGY,Lebanon,49,42,91,0
428,71784,F,LEB,UK,11,78,89,0
429,76578,F,KU,UK,3,9,12,0
430,73306,M,LEB,USA,17,33,50,0
431,55348,F,LEB,Kuwait,86,13,99,0
432,52122,F,EGY,Kuwait,28,81,109,0
433,79998,F,EGY,USA,23,40,63,0
434,73850,F,EGY,Kuwait,5,89,94,0
435,55822,F,LEB,UK,4,52,56,0
436,57929,F,EGY,Egypt,17,38,55,0
437,69897,M,EGY,Kuwait,20,26,46,0
438,61009,M,UK,UK,90,74,164,1
439,55699,F,KU,Egypt,81,23,104,0
440,65268,F,LEB,USA,62,30,92,0
441,66851,M,LEB,Lebanon,84,15,99,0
442,79307,F,KU,USA,29,72,101,0
443,56267,M,KU,UK,31,96,127,1
444,63296,F,US,UK,35,19,54,0
445,70238,M,EGY,USA,17,44,61,0
446,68918,M,LEB,UK,90,66,156,1
447,73415,F,UK,Kuwait,31,46,77,0
448,61824,M,LEB,Kuwait,25,34,59,0
449,59973,M,EGY,USA,32,43,75,0
450,51143,M,LEB,UK,79,32,111,0
451,70310,M,KU,USA,39,65,104,0
452,55786,F,KU,UK,80,71,151,1
453,53024,M,US,Egypt,38,2,40,0
454,76706,M,EGY,UK,95,0,95,0
455,57464,F,UK,Kuwait,43,45,88,0
456,56244,M,EGY,Lebanon,20,46,66,0
457,65488,M,KU,Lebanon,40,62,102,0
458,74412,M,US,USA,62,14,76,0
459,65043,F,UK,Egypt,6,34,40,0
460,67249,F,EGY,Kuwait,47,32,79,0
461,73940,F,KU,Lebanon,67,59,126,1
462,57165,M,KU,Egypt,33,62,95,0
463,75084,M,LEB,UK,85,58,143,1
464,57818,M,KU,Kuwait,35,41,76,0
465,65234,F,EGY,Lebanon,15,9,24,0
466,63613,M,KU,UK,48,70,118,0
467,61059,M,UK,Kuwait,88,63,151,1
468,58033,F,LEB,USA,34,64,98,0
469,50709,F,US,Lebanon,88,13,101,0
470,73843,F,KU,UK,52,30,82,0
471,66137,F,KU,USA,57,71,128,1
472,64726,F,KU,UK,50,28,78,0
473,57953,F,LEB,Kuwait,32,64,96,0
474,53845,M,EGY,USA,9,13,22,0
475,55079,F,UK,Egypt,86,99,185,1
476,61685,M,US,Egypt,76,79,155,1
477,72460,M,LEB,Lebanon,22,98,120,0
478,57298,M,US,Egypt,30,63,93,0
479,74072,F,LEB,Egypt,22,40,62,0
480,66084,M,LEB,Lebanon,19,52,71,0
481,78520,F,EGY,Egypt,9,67,76,0
482,79552,F,US,USA,13,60,73,0
483,58763,F,US,Egypt,89,62,151,1
484,60193,F,KU,UK,50,19,69,0
485,67184,M,EGY,UK,37,3,40,0
486,52426,M,KU,Lebanon,19,39,58,0
487,51376,F,KU,Egypt,97,88,185,1
488,50884,F,KU,USA,3,48,51,0
489,73255,M,UK,Egypt,87,89,176,1
490,67375,M,EGY,Lebanon,95,11,106,0
491,72847,M,UK,USA,9,40,49,0
492,55636,M,LEB,UK,44,61,105,0
493,51092,F,LEB,Egypt,80,44,124,0
494,68612,M,KU,USA,12,87,99,0
495,59369,M,KU,Lebanon,10,66,76,0
496,74019,F,LEB,Kuwait,45,40,85,0
497,65309,F,US,USA,60,23,83,0
498,64470,F,LEB,Egypt,45,49,94,0
499,65707,M,UK,Egypt,47,50,97,0
500,59793,M,KU,Lebanon,88,24,112,0
501,69992,F,EGY,Kuwait,57,99,156,1
502,55856,F,US,Kuwait,73,36,109,0
503,55492,M,LEB,Lebanon,53,54,107,0
504,58308,M,US,Lebanon,4,87,91,0
505,75286,F,EGY,UK,54,63,117,0
506,72115,F,KU,Egypt,100,93,193,1
507,74790,F,EGY,Kuwait,79,91,170,1
508,62137,F,UK,Egypt,63,34,97,0
509,66320,M,US,Kuwait,32,37,69,0
510,64715,M,UK,Kuwait,49,19,68,0
511,79228,M,KU,Lebanon,6,18,24,0
512,53179,F,LEB,Egypt,87,41,128,1
513,63022,F,EGY,Kuwait,49,82,131,1
514,55471,M,EGY,Egypt,91,84,175,1
515,73302,M,UK,USA,44,51,95,0
516,76163,M,UK,Kuwait,98,5,103,0
517,59345,F,LEB,UK,70,54,124,0
518,76602,F,KU,USA,57,71,128,1
519,66954,M,US,Lebanon,14,23,37,0
520,78203,F,EGY,Kuwait,70,3,73,0
521,58151,F,EGY,Egypt,46,1,47,0
522,74052,M,EGY,USA,96,96,192,1
523,78679,M,US,Egypt,31,87,118,0
524,58365,F,UK,UK,41,73,114,0
525,55771,F,KU,USA,17,89,106,0
526,65941,F,UK,Lebanon,53,24,77,0
527,77706,M,LEB,UK,27,28,55,0
528,70038,M,UK,Lebanon,53,60,113,0
529,63896,F,LEB,Kuwait,50,86,136,1
530,65558,F,EGY,Egypt,33,49,82,0
531,75017,M,UK,Egypt,61,54,115,0
532,79099,M,US,Lebanon,2,80,82,0
533,54269,F,KU,Kuwait,80,84,164,1
534,60940,M,UK,Lebanon,3,64,67,0
535,51472,F,UK,USA,57,84,141,1
536,68403,F,UK,USA,81,2,83,0
537,62809,F,LEB,USA,74,13,87,0
538,76024,M,US,USA,11,14,25,0
539,52128,M,KU,Lebanon,49,76,125,1
540,75678,F,US,Lebanon,94,40,134,1
541,61890,M,UK,UK,91,50,141,1
542,72860,M,EGY,Lebanon,98,4,102,0
543,53816,F,LEB,Lebanon,61,13,74,0
544,73639,M,EGY,USA,97,87,184,1
545,74179,M,US,Lebanon,46,10,56,0
546,56427,F,LEB,UK,87,3,90,0
547,59568,M,KU,Lebanon,44,65,109,0
548,75830,F,EGY,Egypt,89,2,91,0
549,73209,M,UK,Egypt,62,52,114,0
550,72955,M,UK,Kuwait,11,24,35,0
551,69130,M,LEB,UK,7,93,100,0
552,54022,F,UK,Egypt,97,90,187,1
553,62534,M,UK,UK,75,33,108,0
554,66207,M,US,Egypt,26,12,38,0
555,50398,F,US,Lebanon,0,78,78,0
556,75409,M,EGY,Egypt,21,96,117,0
557,69557,F,US,Lebanon,4,68,72,0
558,56457,F,EGY,USA,4,46,50,0
559,77163,M,US,USA,71,44,115,0
560,72480,F,KU,Kuwait,94,61,155,1
561,55343,F,LEB,Egypt,98,57,155,1
562,61498,M,EGY,USA,4,21,25,0
563,68031,F,EGY,USA,83,77,160,1
564,51744,M,LEB,Lebanon,93,64,157,1
565,50307,F,UK,USA,76,74,150,1
566,77981,F,EGY,Kuwait,36,30,66,0
567,68777,F,LEB,USA,31,26,57,0
568,72205,M,US,Egypt,48,98,146,1
569,60052,M,US,Kuwait,16,69,85,0
570,69047,F,KU,UK,21,73,94,0
571,73096,M,LEB,UK,90,68,158,1
572,65227,M,LEB,USA,100,94,194,1
573,62014,F,UK,Kuwait,57,38,95,0
574,62185,M,UK,Kuwait,89,72,161,1
575,53296,M,UK,UK,52,89,141,1
576,67420,F,KU,Kuwait,64,54,118,0
577,78936,F,UK,Lebanon,23,2,25,0
578,64197,M,KU,Kuwait,4,15,19,0
579,77363,M,KU,Egypt,5,78,83,0
580,63497,M,EGY,UK,77,92,169,1
581,62359,F,UK,USA,94,82,176,1
582,58350,F,UK,USA,82,2,84,0
583,62991,M,US,UK,93,33,126,1
584,69339,F,LEB,UK,79,42,121,0
585,79657,M,UK,USA,89,0,89,0
586,54741,M,US,UK,2,8,10,0
587,79210,F,KU,USA,31,54,85,0
588,53158,F,EGY,Kuwait,100,24,124,0
589,74328,M,US,Lebanon,88,69,157,1
590,70280,M,LEB,Egypt,14,60,74,0
591,60624,M,KU,UK,58,51,109,0
592,63519,M,EGY,Lebanon,29,36,65,0
593,57843,F,US,Lebanon,43,28,71,0
594,60223,F,KU,Kuwait,36,1,37,0
595,71929,M,EGY,Egypt,34,5,39,0
596,54942,M,UK,Lebanon,58,69,127,1
597,63994,F,UK,USA,6,6,12,0
598,56859,M,LEB,UK,16,31,47,0
599,53164,M,US,Kuwait,70,50,120,0
600,72009,F,UK,USA,80,56,136,1
601,54771,M,LEB,Kuwait,62,11,73,0
602,52281,M,KU,Lebanon,24,59,83,0
603,64783,M,US,Lebanon,25,14,39,0
604,54141,F,EGY,USA,91,92,183,1
605,73013,M,KU,UK,77,62,139,1
606,64778,F,UK,UK,5,93,98,0
607,62712,M,EGY,USA,12,37,49,0
608,76448,M,LEB,USA,6,40,46,0
609,63556,F,US,Kuwait,91,19,110,0
610,54086,F,KU,Kuwait,99,15,114,0
611,67338,F,EGY,Lebanon,60,17,77,0
612,74887,M,UK,UK,81,44,125,1
613,51201,M,EGY,USA,34,67,101,0
614,61505,M,UK,Lebanon,5,30,35,0
615,55953,F,LEB,Kuwait,65,13,78,0
616,53986,M,LEB,Egypt,96,46,142,1
617,55386,M,KU,Egypt,54,99,153,1
618,74574,F,LEB,Egypt,59,82,141,1
619,77878,M,UK,UK,37,84,121,0
620,62946,F,KU,Egypt,16,13,29,0
621,64042,M,US,UK,25,40,65,0
622,75083,M,KU,Kuwait,21,86,107,0
623,79982,F,UK,Kuwait,47,67,114,0
624,75657,M,KU,USA,3,63,66,0
625,54514,F,EGY,Lebanon,67,22,89,0
626,75120,F,UK,USA,66,66,132,1
627,63438,F,KU,UK,66,30,96,0
628,73139,F,KU,Lebanon,100,29,129,1
629,67001,M,US,Lebanon,100,93,193,1
630,60812,M,KU,Lebanon,79,44,123,0
631,69445,M,KU,USA,97,44,141,1
632,78767,F,UK,Egypt,17,42,59,0
633,70693,M,LEB,USA,92,68,160,1
634,70845,F,KU,Lebanon,65,12,77,0
635,67657,F,EGY,Lebanon,81,70,151,1
636,61975,M,UK,USA,71,19,90,0
637,51342,F,UK,USA,53,78,131,1
638,53412,F,US,UK,78,80,158,1
639,67922,F,EGY,USA,65,52,117,0
640,62949,M,LEB,Egypt,30,54,84,0
641,76268,M,UK,Egypt,60,56,116,0
642,54876,F,US,Egypt,30,62,92,0
643,58786,F,US,Egypt,96,9,105,0
644,69928,M,LEB,USA,0,80,80,0
645,62777,F,UK,USA,72,50,122,0
646,61629,F,UK,Lebanon,56,5,61,0
647,57096,M,US,Lebanon,41,34,75,0
648,75190,M,US,UK,27,59,86,0
649,56607,M,KU,Kuwait,75,2,77,0
650,71236,M,LEB,UK,3,86,89,0
651,73384,F,KU,UK,1,78,79,0
652,65394,M,EGY,Egypt,31,62,93,0
653,60943,M,LEB,Kuwait,38,39,77,0
654,75129,F,US,Egypt,79,30,109,0
655,50177,M,KU,USA,70,34,104,0
656,58079,F,US,UK,18,48,66,0
657,56036,M,UK,Egypt,99,93,192,1
658,65210,M,US,Lebanon,99,64,163,1
659,62287,M,LEB,UK,70,87,157,1
660,52617,F,EGY,Lebanon,81,53,134,1
661,53940,M,KU,UK,30,9,39,0
662,60754,F,KU,Kuwait,1,24,25,0
663,78835,F,KU,Kuwait,90,86,176,1
664,59879,F,LEB,Kuwait,18,74,92,0
665,79527,F,US,Egypt,23,79,102,0
666,60879,F,EGY,Lebanon,66,34,100,0
667,60863,F,UK,USA,34,26,60,0
668,60363,F,UK,UK,90,10,100,0
669,51844,M,UK,Lebanon,20,46,66,0
670,53281,M,US,Lebanon,93,10,103,0
671,69373,F,EGY,USA,78,24,102,0
672,69966,F,LEB,USA,14,9,23,0
673,72444,F,LEB,Lebanon,14,38,52,0
674,72211,F,US,UK,42,83,125,1
675,77280,M,KU,USA,98,25,123,0
676,69644,F,UK,Egypt,29,31,60,0
677,77434,M,US,Lebanon,54,64,118,0
678,72384,F,US,Lebanon,20,43,63,0
679,60677,F,KU,Lebanon,28,50,78,0
680,65766,F,UK,Lebanon,2,4,6,0
681,71841,M,LEB,USA,46,94,140,1
682,59657,M,US,Egypt,66,37,103,0
683,72056,M,LEB,Kuwait,1,9,10,0
684,74504,F,US,Kuwait,33,95,128,1
685,64751,F,LEB,UK,92,47,139,1
686,64143,M,EGY,UK,78,62,140,1
687,75929,F,US,UK,52,69,121,0
688,60400,M,UK,Lebanon,44,91,135,1
689,53368,F,US,Kuwait,47,33,80,0
690,52384,M,US,UK,17,5,22,0
691,59616,M,KU,USA,52,81,133,1
692,79959,M,KU,Egypt,54,77,131,1
693,57169,M,LEB,USA,80,23,103,0
694,72047,F,EGY,Egypt,78,31,109,0
695,61249,M,KU,UK,50,76,126,1
696,73270,M,US,USA,62,27,89,0
697,67160,F,LEB,Kuwait,50,50,100,0
698,76294,M,US,Lebanon,65,54,119,0
699,59142,F,KU,Kuwait,68,53,121,0
700,71065,M,LEB,Lebanon,22,62,84,0
701,58052,F,EGY,Lebanon,17,8,25,0
702,51840,M,US,UK,6,15,21,0
703,79357,M,LEB,Egypt,44,45,89,0
704,69628,F,UK,UK,37,91,128,1
705,57336,M,EGY,USA,83,21,104,0
706,78735,M,US,Egypt,57,79,136,1
707,62073,M,US,Egypt,96,76,172,1
708,74693,F,KU,Egypt,74,51,125,1
709,64588,F,US,Lebanon,57,12,69,0
710,66919,F,EGY,USA,55,87,142,1
711,75874,M,US,UK,33,29,62,0
712,55341,F,KU,UK,23,38,61,0
713,64226,M,LEB,UK,52,93,145,1
714,77995,M,US,Kuwait,1,1,2,0
715,64361,M,KU,Lebanon,29,87,116,0
716,79978,F,UK,Egypt,93,59,152,1
717,62135,M,LEB,Egypt,20,16,36,0
718,50187,M,US,Egypt,63,17,80,0
719,50185,M,US,Egypt,90,66,156,1
720,65188,F,US,Egypt,7,48,55,0
721,78580,F,KU,USA,82,74,156,1
722,75478,M,LEB,Lebanon,57,13,70,0
723,63686,M,KU,Kuwait,58,69,127,1
724,74137,F,UK,UK,13,97,110,0
725,69262,F,UK,USA,26,39,65,0
726,53955,F,UK,UK,97,23,120,0
727,51981,M,KU,Kuwait,87,16,103,0
728,69979,F,KU,Egypt,54,93,147,1
729,61587,M,KU,UK,79,85,164,1
730,50596,M,EGY,USA,89,77,166,1
731,66330,F,US,Kuwait,61,48,109,0
732,51557,M,LEB,USA,98,28,126,1
733,67521,M,US,Kuwait,64,54,118,0
734,69140,F,US,Egypt,3,2,5,0
735,74733,F,EGY,Egypt,28,1,29,0
736,52200,F,EGY,Kuwait,61,93,154,1
737,74135,F,KU,Kuwait,14,92,106,0
738,52140,M,US,Kuwait,34,9,43,0
739,50325,M,UK,Kuwait,18,35,53,0
740,70928,M,EGY,UK,100,22,122,0
741,60006,M,US,Kuwait,35,37,72,0
742,70313,F,LEB,UK,75,65,140,1
743,56596,F,LEB,USA,100,17,117,0
744,59138,M,US,USA,96,90,186,1
745,51365,M,UK,Lebanon,83,52,135,1
746,63798,F,LEB,Lebanon,75,99,174,1
747,64152,M,US,USA,20,48,68,0
748,67214,F,LEB,UK,21,32,53,0
749,72222,F,US,UK,5,62,67,0
750,64220,M,US,Lebanon,47,2,49,0
751,72860,F,UK,Egypt,76,27,103,0
752,71506,F,LEB,Egypt,45,25,70,0
753,67948,M,US,UK,70,7,77,0
754,75675,F,LEB,UK,53,86,139,1
755,52857,F,UK,USA,7,44,51,0
756,60805,F,LEB,Egypt,50,58,108,0
757,51762,F,KU,UK,20,2,22,0
758,65113,M,UK,Lebanon,87,28,115,0
759,75647,M,EGY,Kuwait,6,35,41,0
760,52008,F,KU,USA,19,22,41,0
761,63207,M,LEB,USA,28,34,62,0
762,57110,F,EGY,UK,12,97,109,0
763,54047,M,EGY,Lebanon,43,66,109,0
764,61747,M,EGY,Lebanon,27,85,112,0
765,64346,F,UK,Lebanon,4,36,40,0
766,62161,F,LEB,UK,69,4,73,0
767,51417,F,US,USA,71,58,129,1
768,72429,M,KU,Kuwait,41,33,74,0
769,66102,M,UK,UK,50,20,70,0
770,63786,F,KU,Lebanon,64,45,109,0
771,69281,F,KU,Lebanon,39,91,130,1
772,50888,M,US,UK,92,55,147,1
773,52984,F,EGY,USA,15,68,83,0
774,73519,F,KU,UK,37,92,129,1
775,73983,M,US,Lebanon,27,29,56,0
776,74511,M,US,UK,93,16,109,0
777,62740,M,EGY,Kuwait,71,65,136,1
778,70762,F,LEB,USA,62,59,121,0
779,70006,F,US,USA,0,24,24,0
780,78453,F,US,Kuwait,91,70,161,1
781,74883,F,EGY,UK,59,78,137,1
782,76617,M,US,USA,51,7,58,0
783,72462,F,UK,Egypt,60,59,119,0
784,65585,M,EGY,USA,54,55,109,0
785,56005,F,US,UK,48,65,113,0
786,52798,F,EGY,USA,15,55,70,0
787,64386,M,US,Lebanon,8,60,68,0
788,70850,F,UK,UK,43,49,92,0
789,55380,F,LEB,USA,87,49,136,1
790,59608,M,KU,Lebanon,94,51,145,1
791,72804,M,EGY,Lebanon,78,99,177,1
792,76586,M,EGY,Kuwait,99,100,199,1
793,65783,M,LEB,Kuwait,22,43,65,0
794,55740,F,EGY,Lebanon,20,52,72,0
795,78608,F,EGY,Kuwait,51,40,91,0
796,57157,F,EGY,Kuwait,96,15,111,0
797,76752,M,UK,Lebanon,92,45,137,1
798,72043,M,UK,Lebanon,85,28,113,0
799,59160,F,UK,USA,34,38,72,0
800,62076,M,KU,UK,38,56,94,0
801,68259,F,UK,UK,70,6,76,0
802,77620,M,US,Kuwait,60,50,110,0
803,77922,M,LEB,Lebanon,81,82,163,1
804,75398,F,UK,UK,79,4,83,0
805,60288,F,LEB,USA,81,100,181,1
806,77194,M,KU,UK,31,4,35,0
807,56459,F,US,USA,87,92,179,1
808,61374,M,US,UK,98,87,185,1
809,52164,M,US,USA,7,33,40,0
810,75868,M,KU,Kuwait,75,37,112,0
811,59660,F,UK,Kuwait,26,38,64,0
812,50450,M,US,USA,25,29,54,0
813,61733,M,US,UK,10,76,86,0
814,55183,F,US,Kuwait,23,8,31,0
815,71521,F,LEB,Kuwait,16,65,81,0
816,79724,M,KU,USA,93,35,128,1
817,58541,F,EGY,Egypt,0,98,98,0
818,69975,F,US,Egypt,35,40,75,0
819,59019,F,LEB,USA,71,58,129,1
820,72306,M,KU,Kuwait,34,5,39,0
821,54332,F,KU,USA,51,0,51,0
822,56362,F,EGY,Lebanon,34,61,95,0
823,70100,M,LEB,Kuwait,68,56,124,0
824,64455,F,US,USA,14,55,69,0
825,67744,M,LEB,Lebanon,83,84,167,1
826,51524,F,KU,Lebanon,68,52,120,0
827,69242,M,KU,USA,65,99,164,1
828,78973,F,UK,UK,13,89,102,0
829,55256,F,KU,USA,67,90,157,1
830,69985,F,UK,Kuwait,35,77,112,0
831,58724,F,LEB,USA,58,2,60,0
832,65350,F,LEB,Egypt,86,13,99,0
833,55520,M,KU,UK,35,62,97,0
834,68534,M,KU,Egypt,10,22,32,0
835,51432,F,EGY,UK,8,12,20,0
836,79635,M,KU,Lebanon,32,63,95,0
837,66704,M,US,Lebanon,62,52,114,0
838,77557,F,US,UK,90,71,161,1
839,63211,F,LEB,USA,67,32,99,0
840,55605,M,EGY,UK,17,79,96,0
841,75197,M,EGY,Lebanon,95,34,129,1
842,59106,F,EGY,Kuwait,0,78,78,0
843,50099,M,LEB,Egypt,9,7,16,0
844,76309,M,KU,UK,84,56,140,1
845,70641,M,US,UK,20,66,86,0
846,58772,M,UK,USA,15,63,78,0
847,65483,F,US,Egypt,31,8,39,0
848,76706,F,LEB,UK,55,35,90,0
849,79492,F,UK,Egypt,60,68,128,1
850,53655,M,KU,USA,81,59,140,1
851,55516,F,EGY,Kuwait,43,75,118,0
852,59734,F,KU,Kuwait,100,16,116,0
853,55816,F,EGY,Egypt,77,84,161,1
854,51200,M,UK,USA,59,95,154,1
855,63878,F,UK,UK,81,25,106,0
856,78592,M,UK,UK,45,74,119,0
857,51195,F,US,Lebanon,74,17,91,0
858,78302,F,KU,USA,46,17,63,0
859,76115,F,KU,UK,49,57,106,0
860,79468,F,EGY,USA,78,79,157,1
861,57533,M,UK,UK,16,71,87,0
862,75746,M,KU,Kuwait,83,57,140,1
863,60873,M,UK,Kuwait,56,86,142,1
864,62901,M,LEB,UK,65,82,147,1
865,55758,F,EGY,UK,83,63,146,1
866,76138,M,EGY,Kuwait,68,57,125,1
867,62543,M,UK,Kuwait,42,92,134,1
868,57918,F,KU,Lebanon,15,32,47,0
869,76200,M,US,UK,6,39,45,0
870,51633,F,US,Egypt,62,52,114,0
871,57039,F,EGY,UK,90,15,105,0
872,72237,M,LEB,Kuwait,44,24,68,0
873,61788,M,KU,Egypt,4,34,38,0
874,57707,M,US,Egypt,24,1,25,0
875,74756,F,UK,Egypt,89,12,101,0
876,50343,F,KU,Egypt,57,30,87,0
877,54479,F,LEB,UK,77,72,149,1
878,74271,F,KU,Lebanon,97,74,171,1
879,70906,M,LEB,UK,53,65,118,0
880,69836,M,KU,Kuwait,43,96,139,1
881,55832,M,LEB,UK,70,100,170,1
882,54598,M,EGY,Kuwait,84,42,126,1
883,78334,M,US,Egypt,70,83,153,1
884,59100,F,LEB,Egypt,99,48,147,1
885,52013,M,KU,Lebanon,79,33,112,0
886,73354,F,US,Kuwait,97,32,129,1
887,74087,F,LEB,USA,87,75,162,1
888,76929,M,US,Lebanon,51,12,63,0
889,54380,M,EGY,Kuwait,33,93,126,1
890,63811,F,UK,Kuwait,47,34,81,0
891,61227,F,LEB,Egypt,49,27,76,0
892,70293,F,US,UK,19,13,32,0
893,70183,F,LEB,USA,50,29,79,0
894,73246,M,EGY,Kuwait,93,2,95,0
895,55224,F,EGY,Kuwait,75,5,80,0
896,50392,M,LEB,Lebanon,36,34,70,0
897,68714,M,UK,Kuwait,100,77,177,1
898,57098,M,KU,USA,48,58,106,0
899,56749,M,KU,UK,5,25,30,0
900,78504,M,LEB,Lebanon,36,39,75,0
901,57136,F,UK,Kuwait,80,8,88,0
902,72160,F,UK,Egypt,1,50,51,0
903,60940,F,KU,Egypt,46,52,98,0
904,59460,F,EGY,UK,71,98,169,1
905,79634,F,LEB,UK,51,40,91,0
906,66189,F,EGY,USA,94,50,144,1
907,71414,F,EGY,Kuwait,34,36,70,0
908,61478,M,UK,Kuwait,79,68,147,1
909,70909,M,KU,UK,43,17,60,0
910,63685,M,EGY,USA,78,77,155,1
911,79845,M,UK,Lebanon,69,68,137,1
912,62842,F,LEB,Kuwait,10,39,49,0
913,51851,F,UK,Kuwait,21,97,118,0
914,74255,M,EGY,Kuwait,90,95,185,1
915,63598,F,EGY,USA,32,2,34,0
916,62904,M,UK,UK,29,34,63,0
917,52570,F,KU,Lebanon,56,14,70,0
918,59048,M,KU,USA,73,77,150,1
919,54455,M,EGY,UK,79,85,164,1
920,69867,F,US,UK,98,89,187,1
921,60320,F,UK,UK,0,2,2,0
922,56767,F,EGY,Egypt,93,21,114,0
923,68379,F,LEB,USA,72,44,116,0
924,68368,F,US,Lebanon,15,86,101,0
925,72757,M,EGY,Lebanon,13,64,77,0
926,73988,M,EGY,Kuwait,58,14,72,0
927,72565,F,EGY,USA,15,14,29,0
928,62837,F,UK,Kuwait,1,28,29,0
929,79431,F,UK,Kuwait,4,9,13,0
930,78661,M,UK,USA,43,15,58,0
931,61844,F,KU,Egypt,66,91,157,1
932,53307,F,US,USA,100,95,195,1
933,59458,M,KU,USA,85,53,138,1
934,54481,F,LEB,UK,75,29,104,0
935,76731,M,US,USA,64,33,97,0
936,65565,F,KU,UK,24,31,55,0
937,78983,F,UK,Lebanon,5,5,10,0
938,74262,F,UK,Egypt,60,98,158,1
939,57802,M,KU,UK,20,86,106,0
940,72936,F,LEB,USA,19,96,115,0
941,66893,M,EGY,Egypt,74,65,139,1
942,60468,F,KU,Egypt,13,35,48,0
943,77003,M,US,Lebanon,33,10,43,0
944,70009,M,US,Kuwait,99,8,107,0
945,55958,M,US,Egypt,89,98,187,1
946,59965,F,EGY,Kuwait,92,35,127,1
947,52351,M,EGY,UK,100,27,127,1
948,52812,F,UK,Egypt,50,34,84,0
949,68690,F,US,Egypt,4,68,72,0
950,69166,F,EGY,Egypt,83,46,129,1
951,58152,M,UK,Egypt,13,19,32,0
952,77529,F,UK,Lebanon,56,24,80,0
953,77624,F,EGY,Lebanon,43,83,126,1
954,52701,M,EGY,Kuwait,97,88,185,1
955,54601,F,US,Egypt,74,41,115,0
956,74117,M,UK,UK,42,74,116,0
957,51667,F,US,UK,90,93,183,1
958,69140,F,US,Lebanon,96,9,105,0
959,65832,F,UK,Kuwait,26,79,105,0
960,62050,F,LEB,Kuwait,90,73,163,1
961,73668,F,US,USA,94,11,105,0
962,68113,M,LEB,USA,2,7,9,0
963,54306,M,LEB,UK,38,54,92,0
964,66766,M,LEB,Kuwait,79,71,150,1
965,63475,M,EGY,Lebanon,80,16,96,0
966,50457,F,UK,Egypt,1,2,3,0
967,54241,F,LEB,Egypt,75,94,169,1
968,64140,F,UK,Egypt,0,18,18,0
969,77240,M,US,USA,12,32,44,0
970,51551,M,US,Egypt,91,17,108,0
971,54479,F,UK,USA,16,55,71,0
972,64758,F,UK,Lebanon,82,71,153,1
973,69349,M,US,USA,59,94,153,1
974,69624,M,UK,Kuwait,44,95,139,1
975,79130,F,LEB,Lebanon,44,0,44,0
976,69427,M,LEB,Kuwait,28,56,84,0
977,76182,M,LEB,Egypt,25,21,46,0
978,52682,M,EGY,Lebanon,29,22,51,0
979,57999,M,KU,USA,81,83,164,1
980,51491,F,UK,Egypt,66,11,77,0
981,79902,M,LEB,UK,49,3,52,0
982,54139,F,US,Lebanon,88,41,129,1
983,72339,F,KU,Lebanon,61,21,82,0
984,68495,F,LEB,UK,46,49,95,0
985,73685,M,EGY,Lebanon,51,80,131,1
986,57982,F,EGY,Lebanon,60,80,140,1
987,54695,M,EGY,Kuwait,100,92,192,1
988,73399,F,US,Lebanon,26,24,50,0
989,67540,F,LEB,Kuwait,57,85,142,1
990,64578,F,US,Lebanon,71,18,89,0
991,73155,F,KU,Lebanon,8,52,60,0
992,64122,F,KU,USA,33,80,113,0
993,63090,M,EGY,USA,97,96,193,1
994,65703,F,US,Kuwait,56,45,101,0
995,57302,M,EGY,UK,34,73,107,0
996,68067,F,LEB,USA,59,76,135,1
997,63000,F,UK,Egypt,35,11,46,0
998,55439,F,LEB,UK,4,95,99,0
999,78646,F,UK,Egypt,16,43,59,0
